1 1 1 1 1 1 1 1 1 1 1 1 1 1 1 1 1 1 1 1
1 0 0 0 0 0 0 1 1 1 0 0 0 0 0 0 0 0 0 1
1 0 10 0 0 0 0 0 8 0 0 0 0 0 0 0 0 0 0 1
1 1 1 1 1 1 1 1 1 1 1 0 0 3 0 0 0 0 0 1
1 0 0 0 0 0 0 0 0 0 1 1 0 0 0 0 0 0 0 1
1 0 0 0 0 0 0 0 0 0 1 1 88 88 1 0 0 0 0 1
1 0 0 0 0 0 0 4 0 0 1 0 0 0 0 1 0 0 0 1
1 0 0 0 9 3 0 0 0 0 6 0 0 0 0 0 0 0 1 1
1 0 0 0 1 1 99 99 1 1 1 1 5 7 0 0 0 0 0 1
1 0 0 0 0 0 0 0 0 0 0 1 1 1 1 1 1 0 0 1
1 0 1 1 0 0 5 0 0 0 0 1 0 0 0 0 0 0 1 1
1 0 0 0 0 1 1 0 0 0 0 1 0 0 0 0 0 1 1 1
1 0 0 0 0 0 0 0 1 0 0 1 0 0 0 1 1 1 0 1
1 0 0 0 0 0 0 4 0 0 0 1 0 0 0 0 4 0 0 1
1 1 1 1 1 1 1 1 1 1 0 1 1 1 1 1 1 1 1 1
1 1 1 1 1 1 1 1 1 1 0 1 1 1 1 1 1 1 1 1